C 36,42,107
F 33,35,38

NO ./textures/north.png
EA ./textures/east.png
SO ./textures/south.png
WE ./textures/west.png

        11111111111111111111111
        11000000000010011100001                              1111111111111111111111111111
        11000000111100000000001                              1000000000000000000000000001
        11000000000100000100011                111  111      1000000000000000000000000001
111111111111111111111100010001111111111        101  101      1000000000000000000000000001
10000000111111111110110001001111111100111111111101111011111111000000000000000000000000001
10000000100000011110111111011111110000000000000000000000000000000000000000000000000000001
1E000000000000000000000000111111000001111111111111111011111111000000000000000000000000001
100000001000000111111101111111111010000111          101      1000000000000000000000000001
100000001111111110100000000000000010000111          111      1000000000000000000000000001
1111111111111111100000011111000000011111                     1000000000000000000000000001
        1111111111110001000000011111                         1111111111111111111111111111
        1111111111110001000100000001
        1111111111111111111111111111
