EA ./textures/east.png
NO ./textures/north.png
SO ./textures/south.png
WE ./textures/west.png

C 255,255,255
F 255,255,0

                             111111111
                           1110000000111
                       111110000000000011111
      1111111111111111110000000000000000000111111111111111111
   1111000000000000000010000000000000000000100000000000000001111
 11100000000000000000001111111000000011111110000000000000000000111
1100000000000000000000010000010000000100000100000000000000000000011
1000000000000000000000010000010000000100000100000000000000000000001
1000000000000000000000010000010000000100000100000000000000000000001
1100000000000000000000010000010000000100000100000000000000000000011
 11000000000000000000001000001000000010000010000000000000000000111
  11000000000000000111111111110000000111111111110000000000000001
   1100000000000000100000000000011110000000000010000000000000011
    10000000000000010000000000001  1000000000001000000000000001
    10000000000000010000000000001  1000000000001000000000000001
    10000000000000010000000000001111000000000001000000000000001
    11000000011101111000000000000000000000000001111110000000011
     100000001000000000000000000000000000000000000001000000001
     100000001000000000000000000N00000000000000000001000000001
     111111111111100000000000000000000000000000001111111111111
        1110000000000000000000000000000000000000000000001111
      111000000000000111110000000000000000111110000000000001111
    1110000000000000011  1100000000000000011  1100000000000000111
  11100000000000000111    10000000000000001    11100000000000000111
 1100000000000000111      11111111111111111      1110000000000000011
  1110000000000111                                 1110000000000111
    111000000111                                     111000000111
      11100111                                         11100111
        1111                                             1111