WE textures/west.png
EA textures/east.png

F  141,        1,      126

C     0        ,183      ,183

SO                   textures/south.png
NO textures/north.png

111111            1111111111
100001            1000e00001
100001            1000000001
100001            1001110001
100001  11111     1111 10001
100001  10001          10001
100001  10001          10001
100001  10001          10001
100001  10001          10001
100001  10001          10001
100001  10001     1111110001
1000011110001     1000000001
1000000000i01     1000111111
10000000000011111110001
11111110E00000000000001
      10000011111110001111111
      1000001     100p0000001
      1111111     11111111111
