WE textures/west.png
EA ./textures/east.png
C 7,7,7
F  47,6,7
SO                textures/south.png
NO textures/north.png
1111111111111111
1000100000000001
1000100000000001
1000100000000011
1000S00000000111
1000100000001111
1000100000011111
11001000000111111
111111111111111

