WE textures/west.xpm42
EA ./textures/east.xpm42

F  4,        1,      126

C 0,183,183

SO                   textures/south.xpm42
NO textures/north.xpm42

111111111
100000001
100000001
111110001
    10001
    10001
    10001
    10001
    1S001
    11111111111111
