
F 255,255,255
C 255,255,255

WE ./textures/east.png
EA ./textures/east.png
NO textures/north.png
SO  textures/north.png

     1111111111111
111111111000000001
10001D101000000001
10001DN1111111111
111111111
111111111
111111 11
