WE textures/west.xpm
EA textures/east.xpm

F  141,        1,      126

C 1, 3 ,4

SO                   textures/south.xpm
NO textures/north.xpm

111111            1111111111
100001            1000000001
100001            1000000001
100001            1001110001
100001  11111     1111 10001
100001  10001          10001
100001  10001          10001
100001  10001          10001
100001  10001          10001
100001  10001          10001
100001  10001     1111110001
1000011110001     1000000001
1000000000001     1000111111
10000000000011111110001
11111110E00000000000001
      10000011111110001111111
      1000001     10000000001
      1111111     11111111111
