EA ./textures/east.png

C 25,255,123

WE ./textures/west.png

NO textures/south.png
SO  textures/north.png


F 255,255,255
11111
1S11
11 11

