F  4,9,7
C 09,7,9
WE textures/west.png
EA ./textures/east.png
SO                textures/south.png
NO textures/north.png
1111111111111111
1000100000000001
1000100000000001
1000100000000011
1000S00000000111
1000100000001111
100010000001
11001000000111111
1111111111111

