F  255,255,255
C 255,255,255





WE ./textures/east.png
EA ./textures/east.png
NO textures/north.png
SO  textures/north.png








 11111111111111111111
100010000000001
10001000000000011111
 1F00100000000011
 1000D00F0000111
 10001000S0001111
 1000D00000011
 11001000000111111
111101101111
 111D11D1111111111111
 100010000000001
10001000000000011111
 10001000000000011
 10000000F000111
 1000100000001111
 1000D00000011
 11001000000111111
111111111111
