F  3,234,4
C 3,3,11




NO textures/north.png
WE ./textures/east.png
EA ./textures/east.png
SO                textures/south.png









 11111111111111111111
100010000000001
10001000000000011111
 1000100000000011
 100000000000111
 1000100000001111
 1000100000011
 11001000000111111
111111111111
 11111111111111111111
 100010000000001
10001000000000011111
 10001000000S00011
 100000000000111
 1000100000001111
 1000100000011
 11001000000111111
111111111111
