WE textures/west.xpm
EA ./textures/east.xpm

F  23423327845692387562398756239874562398475623987456239874642342342342324,        1,      126

C 0,183,183

SO                   textures/south.xpm
NO textures/north.xpm

        111111
        100001
        100001
        111011            1111111111
        100001            1000000001
        100001            1000000001
        100001            1001110001
        100001  11111     1111 10001
        100001  10001          10001
11111111100001  10001          100011111111111
10000000000001  10001          100000000000001
10000000000001  10001          100011111111111
11111111100001  10001          10001
        100001  10001     1111110001
        1000011110001     1000000001
        1000000000001     1000111111
        10000000000011111110001
        11111110E00020020020001
              1000001111111000111111111111
              1000001     1000000000000001
              1110111     1111111111111111
              1000001
              1000001
              1111111
