WE textures/west.png
EA ./textures/east.png

F  4,        1,      126

C 0,183,183

SO                   textures/south.png
NO textures/north.png

1111111111111111
1000100000000001
1000100000000001
1000100000000011
1000S00000000111
1000100000001111
1000100000011111
1100100000111111
1111111111111111

1111111111111111
1000100000000001
1000100000000001
1000100000000011
1000S00000000111
10001000000011110fsd
1000100000011111
1100100000111111
1111111111111111

111111111111111111111111111
100001010020000000011000101
104000020010111111011010001
100001010010100001011011011
111111110010101101011010001
100000000010111101000011011
101112111010000001000010001
101110111011111111112111011
101110111000000000000000001
101110111000000012100000001
101110111000000010100000001
102000002000000100010000001
101110111000011000001100001
10111011100002000N000200001
101110111000011000001100001
101110111000000100010000001
101110111000000010100000001
101112111000000012100000001
100000000000000000000000001
111111111111111111111111111

11111111111111111   11111
10000000000000001   10001
10000000000000001   10001
1000000000000000111110001
1000000000000000000000001
1000000000000000000000001
1000000000000000000000001
1000000000000000000000001
1000000000000000000000001
1000000000000000000000001
1000000000000000000000001
1000000000000000000000001
1000000000000000000000001
1000000000000000000000001
1000000000000000000000001
1000000000000000000000001
1000000000000000000000001
1000000000000000000000001
1000000000000000000000001
11111000000000000000000011111
    100000000000E000000000001
11111000000000001000000011111
1000000000000000000000001
1000000000000000000000001
1111111111111111111111111
