WE textures/west.xpm
EA ./textures/east.xpm

F  4,        1,      126

C 0,183,183

SO                   textures/south.xpm

NO textures/north.xpm


1111  111111111111
100111100010000001
100000001000000111
11N1000010000001
1000000011011111
110000000000000000000000000001
1000000010000001
1110000000000011
1111111111111111
