WE textures/west.png
EA ./textures/east.png

F  4,        1,      126

C 0,183,183

SO                   textures/south.png
NO textures/north.png

1111111111111111
1000100000000001
1000100000000001
1000100000000011
1000S00000000111
1000100000001111
1000100000011111
1100100000111111
1111111111111111
