                                                                                       C                                    36,42,107
F 33,35,38

NO ./textures/north.xpm
EA ./textures/east.xpm
SO ./textures/south.xpm
WE ./textures/west.xpm


        11111111111111111111111
        10000000000000000000001111111
        11000000000010011100000000001                        111111111111111111
        11000000111100000D00001111111                        1B000000000000B0011111111111
        11000000000100000100011                111  111      10PPPPPPPPPPPP00000000000001
111111111111111111111100010001111111111        1L1  1B1      10P0B00BB00B0P011111111110011
100000001111111111101100010011111111BB1111111111D1111D111111110P0LLLLLLLL0P0111      10001
100LLL001PPPPPP1111D1111110111111100L00L0L0L0L0L0L0L0L0L00D00000000000000000001      10001
1E000000D0000000000000000D111111B00001111111111111111D111111110P0LLLLLLLL0P0111      10001
100LLL001PPPPPP1111111D1111111111D10L0P111          1P1      10P0B00BB00B0P01        10011
10000000111111111B10000000000000001000P111       111101      10PPPPPPPPPPPP01        1001
1111111111111111100000011111000000D11111         100001      1B000000000000B1        1001
        1111111111110L010L0D00011111             111111      1111111111001111        1001
        111111111111B0010001B00D00B1                                  110011         1001
        1111111111111111111111111111                                   110011        1001
                                                                        110011       1001
                                                                         110011      1001
                                                                          110011111111001
                                                                           11000000000001
                                                                            1111111111111
