                                                                                       C                                    36,42,107
F 33,35,38

NO ./textures/north.png
EA ./textures/east.png
SO ./textures/south.png
WE ./textures/west.png


        11111111111111111111111
        10000000000000000000001111111
        11000000000010011100000000001                        111111111111111111
        11000000111100000000001111111                        1000000000000000011111111111
        11000000000100000100011                111  111      1000000000000000000000000001
111111111111111111111100010001111111111        1S1  101      10000000000000011111111110011
1000000011111111111011000100111111110011111111110111101111111100000000000000111      10001
1000000010000001111011111101111111000000000000000000000000000000000000000000001      10001
10000N0000000000000000000011111100000111111111111111101111111100000000000000111      10001
100000001000000111111101111111111010000111          101      1000000000000001        10011
100000001111111110100000000000000010000111       111101      1000000000000001        1001
1111111111111111100000011111000000011111         100001      1000000000000001        1001
        1111111111110001000000011111             111111      1111111111001111        1001
        1111111111110001000100000001                                  110011         1001
        1111111111111111111111111111                                   110011        1001
                                                                        110011       1001
                                                                         110011      1001
                                                                          110011111111001
                                                                           11000000000001
                                                                            1111111111111
