C 36,42,107
F 33,35,38

NO ./textures/north.xpm
EA ./textures/east.xpm
SO ./textures/south.xpm
WE ./textures/west.xpm

        11111111111111111111111
        11000000000010011100001                              111111111
        11000000111100000000001                              100000001
        11000000000100000100011                111  111      100000001
111111111111111111111100010001111111111        101  101      100000001
1000000011111111111011000100111111110011111111110111101111111100000001
10000000100000011110111111011111110000000000000000000000000000000000E1
1000000000000000000000000011111100000111111111111111101111111100000001
100000001000000111111101111111111010000111          101      100000001
100000001111111110100000000000000010000111          111      100000001
1111111111111111100000011111000000011111                     100000001
        1111111111110000000000011111                         111111111
        1111111111110001000100000001
        1111111111111111111111111111
