NO textures/north.png
EA ./textures/east.png
SO ./textures/south.png
WE ./textures/west.png

F 220,100,0
C 100,130,35

D ./textures/door.png
L
A ./textures/super_mario.png
P 


        111111 111111111111111111
        100D01 100111000000000001
        1011001001111000001000001
        1001000000000000000100001
111111111011000001110000000000001
100000000011000001110111111111111
11110111111111011100000010001
1111D111111111011101010010011
110P0P001101010111000000101
P0000000000000001100000010011
10E000A0000000001101010000001
110110111010101111101111000111
1111 111 1110101 101111010001
1111 111 11111111 111111111111
