11111111111111111111111111111111
10000000000000000000000000000001
11000000000000000000000000000001
110000000000001    1000000000001
111111000000001    1000000000001
100000000000001    1000000000001
111111111111111    1111111111111
