NO ./textures/north.xpm
EA ./textures/east.xpm
SO ./textures/south.xpm
WE ./textures/west.xpm

F 86,125,70
C 135,206,235

111111111111111111111111111
100001010020000000011000101
104000020010111111011010001
100001010010100001011011011
111111110010101101011010001
100000000010111101000011011
101112111010000001000010001
101110111011111111112111011
101110111000000000000000001
101110111000000012100000001
101110111000000010100000001
102000002000000100010000001
101110111000011000001100001
10111011100002000N000200001
101110111000011000001100001
101110111000000100010000001
101110111000000010100000001
101112111000000012100000001
100000000000000000000000001
111111111110111111111111111
