NO ./textures/north_bonus.png
SO ./textures/west_bonus.png
WE ./textures/south_bonus.png
EA ./textures/east_bonus.png

F 150,50,20
C 0,0,0

111111111111111111111111
1F000010100000000F0000X1
101110101110111111111111
10100000000F1
1110101111111
1010100010001
1111111010101
1110111000101
1010001010101
1111101F10101
1010101010001
111D111011101
1010001010001
1110101010101
10101F10101F1
1110111010111
1000100010001
1110111111101
10000F10000F1
1010111011111
1010100000001
1110111111101
101000101F001
1111100010101
10001000001D111111111111
111011101000000000000S01
111111111111111111111111