NO ./textures/north.png
SO ./textures/west.png
WE ./textures/south.png
EA ./textures/east.png

F 220,100,23
C 225,30,43

111111111111111111111111111111111111111111111111111111111111111111111111111111111111111111111111111111111111111111111111111111111111111111111111111111111111111111111111111111111111111111111111111111111111111111111111111111111111111111111111111111111111111111111111111111111111111111111111111111111
100000100010000010000000100000000010100000000000000000000000000000000000000000000000000000000000000110000000000000000000000000000000000000000000000000000000000000000000000000000000000000000000000000011000000000000000000000000000000000000000000000000000000000000000000000000000000000000000011111111
111010101010111010111011101110111010111011111111111111111111111111111111111111111111111111111111111111111111111111111111111111111111111111111111111111111111111111111111111111111111111111111111111111111111111111111111111111111111111111111111111111111111111111111111111111111111111111111111111111111
10001000101010101000100000101010000000001
10101110111110101111111010101110111111111
10101010100000000010000010100010100010001
10111011111111111010111110101111111010101
10101010001000001010000010000010100000101
10101010101110111011101011111110111111101
10000010101000001000001010100010001000001
10101010111111101110100010101111101011101
10101000000010000010000000000010000000101
11101010111110111010100001101110111111111
10101010000000100000101000100000100000001
10101110111010111010101111111110101111101
10001000001010001010101000000010000010101
10111011101110101011111011101110111010101
10100010001010101000001000100010001010101
10111010101011101111101011101111101010101
10100010101000101000100000100010101010001
10111010101110101110101011111110111011101
10101010100000101000001000100010001010101
10101110101111111110101111101110101010101
10001000100010000000100010000010101010101
10101011101010101111111110111110111010111
10101010001010100000000000100000100010001
10101011111011111111111110101111111111101
10101000101000001000001000101000001000001
11101110101111111010111110101010111011111
10001000000010000010100010000010100000001
10111111111011101010101111111110111111101
10100000001000001010000010000010001010001
11101010111110111011111010111111101010101
10001010100000100000001010100000100010101
10101110101011101111101110101110111010111
10101000101010000010000010001000000010001
10101011101010111011111111111010111010101
10101000001010101000000000001010001000101
10101111111010101011101111101011101111101
10100000100010001000000000101010000000101
11111111111111111101111111111111111111111
11111111111111111101111111111111111111111
10000010001000001000000010000000001010001
11101010101011101011101110111011101011101
10001000101010101000100000101010000000001
10101110111110101111111010101110111111111
10101010100000000010000010100010100010001
10111011111111111010111110101111111010101
10101010001000001010000010000010100000101
10101010101110111011101011111110111111101
10000010101000001000001010100010001000001
10101010111111101110100010101111101011101
10101000000010000010000000000010000000101
11101010111110111010100001101110111111111
10101010000000100000101000100000100000001
10101110111010111010101111111110101111101
10001000001010001010101000000010000010101
10111011101110101011111011101110111010101
10100010001010101000001000100010001010101
10111010101011101111101011101111101010101
10100010101000101000100000100010101010001
10111010101110101110101011111110111011101
10101010100000101000001000100010001010101
10101110101111111110101111101110101010101
10001000100010000000100010000010101010101
10101011101010101111111110111110111010111
10101010001010100000000000100000100010001
10101011111011111111111110101111111111101
10101000101000001000001000101000001000001
11101110101111111010111110101010111011111
10001000000010000010100010000010100000001
10111111111011101010101111111110111111101
10100000001000001010000010000010001010001
1110101011111011101111101011111110101010111                                                                                                                                                                                                                                                   111111111
100010101000001000000010101000001000101011111111111111111111111111111111111111111111111111111111111111111111111111111111111111111111111111111111111111111111111111111111111111111111111111111111111111111111111111111111111111111111111111111111111111111111111111111111111111111111111111111111000111111
1010111010101110111110111010111011101000000000000000000000000000000000000000000000000000000000000000000000000000000000000000000000000000000000000000000000000000000000000000000000000000000000000000000000000000000000000000000000000000000000000000000000000000000000000000000000000000000000000S011111
101010001010100000100000100010000000100011111111111111111111111111111111111111111111111111111111111111111111111111111111111111111111111111111111111111111111111111111111111111111111111111111111111111111111111111111111111111111111111111111111111111111111111111111111111111111111111111111111100111111
10101011101010111011111111111010111011111                                                                                                                                                                                                                                                       1111
10101000001010101000000000001010001000101
10101111111010101011101111101011101111101
10100000100010001000000000101010000000101
11111111111111111101111111111111111111111
11111111111111111101111111111111111111111
10000010001000001000000010000000001010001
11101010101011101011101110111011101011101
10001000101010101000100000101010000000001
10101110111110101111111010101110111111111
10101010100000000010000010100010100010001
10111011111111111010111110101111111010101
10101010001000001010000010000010100000101
10101010101110111011101011111110111111101
10000010101000001000001010100010001000001
10101010111111101110100010101111101011101
10101000000010000010000000000010000000101
11101010111110111010100001101110111111111
10101010000000100000101000100000100000001
10101110111010111010101111111110101111101
10001000001010001010101000000010000010101
10111011101110101011111011101110111010101
10100010001010101000001000100010001010101
10111010101011101111101011101111101010101
10100010101000101000100000100010101010001
10111010101110101110101011111110111011101
10101010100000101000001000100010001010101
10101110101111111110101111101110101010101
10001000100010000000100010000010101010101
10101011101010101111111110111110111010111
10101010001010100000000000100000100010001
10101011111011111111111110101111111111101
10101000101000001000001000101000001000001
11101110101111111010111110101010111011111
10001000000010000010100010000010100000001
10111111111011101010101111111110111111101
10100000001000001010000010000010001010001
11101010111110111011111010111111101010101
10001010100000100000001010100000100010101
10101110101011101111101110101110111010111
10101000101010000010000010001000000010001
10101011101010111011111111111010111010101
10101000001010101000000000001010001000101
10101111111010101011101111101011101111101
10100000100010001000000000101010000000101
11111111111111111101111111111111111111111
11111111111111111101111111111111111111111
10000010001000001000000010000000001010001
11101010101011101011101110111011101011101
10001000101010101000100000101010000000001
10101110111110101111111010101110111111111
10101010100000000010000010100010100010001
10111011111111111010111110101111111010101
10101010001000001010000010000010100000101
10101010101110111011101011111110111111101
10000010101000001000001010100010001000001
10101010111111101110100010101111101011101
10101000000010000010000000000010000000101
11101010111110111010100001101110111111111
10101010000000100000101000100000100000001
10101110111010111010101111111110101111101
10001000001010001010101000000010000010101
10111011101110101011111011101110111010101
10100010001010101000001000100010001010101
10111010101011101111101011101111101010101
10100010101000101000100000100010101010001
10111010101110101110101011111110111011101
10101010100000101000001000100010001010101
10101110101111111110101111101110101010101
10001000100010000000100010000010101010101
10101011101010101111111110111110111010111
10101010001010100000000000100000100010001
10101011111011111111111110101111111111101
10101000101000001000001000101000001000001
11101110101111111010111110101010111011111
10001000000010000010100010000010100000001
10111111111011101010101111111110111111101
10100000001000001010000010000010001010001
11101010111110111011111010111111101010101
10001010100000100000001010100000100010101
10101110101011101111101110101110111010111
10101000101010000010000010001000000010001
10101011101010111011111111111010111010101
10101000001010101000000000001010001000101
10101111111010101011101111101011101111101
10100000100010001010000000101010000000101
11111111111111111111111111111111111111111
11111111111111111101111111111111111111111
10000010001000001000000010000000001010001
11101010101011101011101110111011101011101
10001000101010101000100000101010000000001
10101110111110101111111010101110111111111
10101010100000000010000010100010100010001
10111011111111111010111110101111111010101
10101010001000001010000010000010100000101
10101010101110111011101011111110111111101
10000010101000001000001010100010001000001
10101010111111101110100010101111101011101
10101000000010000010000000000010000000101
11101010111110111010100001101110111111111
10101010000000100000101000100000100000001
10101110111010111010101111111110101111101
10001000001010001010101000000010000010101
10111011101110101011111011101110111010101
10100010001010101000001000100010001010101
10111010101011101111101011101111101010101
10100010101000101000100000100010101010001
10111010101110101110101011111110111011101
10101010100000101000001000100010001010101
10101110101111111110101111101110101010101
10001000100010000000100010000010101010101
10101011101010101111111110111110111010111
10101010001010100000000000100000100010001
10101011111011111111111110101111111111101
10101000101000001000001000101000001000001
11101110101111111010111110101010111011111
10001000000010000010100010000010100000001
10111111111011101010101111111110111111101
10100000001000001010000010000010001010001
11101010111110111011111010111111101010101
10001010100000100000001010100000100010101
10101110101011101111101110101110111010111
10101000101010000010000010001000000010001
10101011101010111011111111111010111010101
10101000001010101000000000001010001000101
10101111111010101011101111101011101111101
10100000100010001010000000101010000000101
11111111111111111111111111111111111111111
11111111111111111101111111111111111111111
10000010001000001000000010000000001010001
11101010101011101011101110111011101011101
10001000101010101000100000101010000000001
10101110111110101111111010101110111111111
10101010100000000010000010100010100010001
10111011111111111010111110101111111010101
10101010001000001010000010000010100000101
10101010101110111011101011111110111111101
10000010101000001000001010100010001000001
10101010111111101110100010101111101011101
10101000000010000010000000000010000000101
11101010111110111010100001101110111111111
10101010000000100000101000100000100000001
10101110111010111010101111111110101111101
10001000001010001010101000000010000010101
10111011101110101011111011101110111010101
10100010001010101000001000100010001010101
10111010101011101111101011101111101010101
10100010101000101000100000100010101010001
10111010101110101110101011111110111011101
10101010100000101000001000100010001010101
10101110101111111110101111101110101010101
10001000100010000000100010000010101010101
10101011101010101111111110111110111010111
10101010001010100000000000100000100010001
10101011111011111111111110101111111111101
10101000101000001000001000101000001000001
11101110101111111010111110101010111011111
10001000000010000010100010000010100000001
10111111111011101010101111111110111111101
10100000001000001010000010000010001010001
11101010111110111011111010111111101010101
10001010100000100000001010100000100010101
10101110101011101111101110101110111010111
10101000101010000010000010001000000010001
10101011101010111011111111111010111010101
10101000001010101000000000001010001000101
10101111111010101011101111101011101111101
10100000100010001010000000101010000000101
11111111111111111111111111111111111111111
11111111111111111101111111111111111111111
10000010001000001000000010000000001010001
11101010101011101011101110111011101011101
10001000101010101000100000101010000000001
10101110111110101111111010101110111111111
10101010100000000010000010100010100010001
10111011111111111010111110101111111010101
10101010001000001010000010000010100000101
10101010101110111011101011111110111111101
10000010101000001000001010100010001000001
10101010111111101110100010101111101011101
10101000000010000010000000000010000000101
11101010111110111010100001101110111111111
10101010000000100000101000100000100000001
10101110111010111010101111111110101111101
10001000001010001010101000000010000010101
10111011101110101011111011101110111010101
10100010001010101000001000100010001010101
10111010101011101111101011101111101010101
10100010101000101000100000100010101010001
10111010101110101110101011111110111011101
10101010100000101000001000100010001010101
10101110101111111110101111101110101010101
10001000100010000000100010000010101010101
10101011101010101111111110111110111010111
10101010001010100000000000100000100010001
10101011111011111111111110101111111111101
10101000101000001000001000101000001000001
11101110101111111010111110101010111011111
10001000000010000010100010000010100000001
10111111111011101010101111111110111111101
10100000001000001010000010000010001010001
11101010111110111011111010111111101010101
10001010100000100000001010100000100010101
10101110101011101111101110101110111010111
10101000101010000010000010001000000010001
10101011101010111011111111111010111010101
10101000001010101000000000001010001000101
10101111111010101011101111101011101111101
10100000100010001010000000101010000000101
11111111111111111111111111111111111111111
11111111111111111111111111111111111111111
11111111111111111111111111111111111111111
11111111111111111111111111111111111111111
11111111111111111111111111111111111111111
11111111111111111111111111111111111111111
11111111111111111111111111111111111111111
11111111111111111111111111111111111111111
111111111111111111111111111111111111111111111111111111111111111111111111111111111111111111111111111111111111111111111111111111111111111111111111111111111111111111111111111111111111111111111111111111111111111111111111111111111111111111111111111111111111111111111111111111111111111111111111111111111
100000000000000000000000000000000000000000000000000000000000000000000000000000000000000000000000000110000000000000000000000000000000000000000000000000000000000000000000000000000000000000000000000000011000000000000000000000000000000000000000000000000000000000000000000000000000000000000000011111111
111111111111111111111111111111111111111111111111111111111111111111111111111111111111111111111111111111111111111111111111111111111111111111111111111111111111111111111111111111111111111111111111111111111111111111111111111111111111111111111111111111111111111111111111111111111111111111111111111111111
